NO ./exec/img2.xpm
SO ./exec/img1.xpm
 WE ./exec/img4.xpm
EA ./exec/img3.xpm

F 188,143,143
 C 250,200,210



   111111111
   10000000111
   10010001001
11110P00000001
10000000001111111111111111111111111111111111111
100000100000000100000000000100000000000100000001
10000000000000001000000000001000000000001000000111
10000010000000000010000000000010000000000010000001
10000000000000001000000000001000000000001000000001
10000010000000010000000000010000000000010000000001
11111111111111111111111111111111111111111111111111